/location/statistical_region/rent50_2./measurement_unit/dated_money_value/currency	/location/statistical_region	/finance/currency
/organization/organization_member/member_of./organization/organization_membership/organization	/organization/organization_member	/organization/membership_organization
/government/politician/government_positions_held./government/government_position_held/jurisdiction_of_office	/government/politician	/government/governmental_jurisdiction
/film/actor/dubbing_performances./film/dubbing_performance/language	/film/actor	/language/human_language
/education/field_of_study/students_majoring./education/education/major_field_of_study	/education/field_of_study	/education/field_of_study
/location/capital_of_administrative_division/capital_of./location/administrative_division_capital_relationship/administrative_division	/location/capital_of_administrative_division	/location/administrative_division
/baseball/baseball_team/team_stats./baseball/baseball_team_stats/season	/baseball/baseball_team	/sports/sports_league_season
/award/award_category/disciplines_or_subjects	/award/award_category	/award/award_discipline
/user/jg/default_domain/olympic_games/sports	/user/jg/default_domain/olympic_games	/user/jg/default_domain/olympic_sport
/people/person/nationality	/people/person	/location/country
/base/biblioness/bibs_location/state	/base/biblioness/bibs_location	/location/location
/music/genre/parent_genre	/music/genre	/music/genre
/music/group_member/membership./music/group_membership/group	/music/group_member	/music/musical_group
/film/film/film_art_direction_by	/film/film	/film/film_art_director
/people/cause_of_death/people	/people/cause_of_death	/people/deceased_person
/base/aareas/schema/administrative_area/administrative_parent	/base/aareas/schema/administrative_area	/base/aareas/schema/administrative_area
/music/genre/artists	/music/genre	/music/artist
/government/political_party/politicians_in_this_party./government/political_party_tenure/politician	/government/political_party	/government/politician
/people/deceased_person/place_of_burial	/people/deceased_person	/people/place_of_interment
/music/artist/contribution./music/recording_contribution/performance_role	/music/artist	/music/performance_role
/base/localfood/seasonal_month/produce_available./base/localfood/produce_availability/seasonal_months	/base/localfood/seasonal_month	/base/localfood/seasonal_month
/education/educational_institution_campus/educational_institution	/education/educational_institution_campus	/education/educational_institution
/award/award_winner/awards_won./award/award_honor/award_winner	/award/award_winner	/award/award_winner
/medicine/disease/risk_factors	/medicine/disease	/medicine/risk_factor
/people/ethnicity/geographic_distribution	/people/ethnicity	/location/location
/tv/tv_program/genre	/tv/tv_program	/tv/tv_genre
/sports/sports_position/players./sports/sports_team_roster/position	/sports/sports_position	/sports/sports_position
/sports/sports_league/teams./sports/sports_league_participation/team	/sports/sports_league	/sports/sports_team
/people/person/place_of_birth	/people/person	/location/location
/base/aareas/schema/administrative_area/capital	/base/aareas/schema/administrative_area	/base/aareas/schema/earth/citytown
/education/university/domestic_tuition./measurement_unit/dated_money_value/currency	/education/university	/finance/currency
/people/profession/specialization_of	/people/profession	/people/profession
/music/instrument/instrumentalists	/music/instrument	/music/group_member
/sports/sports_team/colors	/sports/sports_team	/visual_art/color
/people/person/sibling_s./people/sibling_relationship/sibling	/people/person	/people/person
/film/film/dubbing_performances./film/dubbing_performance/actor	/film/film	/film/actor
/film/film/release_date_s./film/film_regional_release_date/film_regional_debut_venue	/film/film	/film/film_screening_venue
/base/biblioness/bibs_location/country	/base/biblioness/bibs_location	/location/location
/education/educational_institution/students_graduates./education/education/major_field_of_study	/education/educational_institution	/education/field_of_study
/base/americancomedy/celebrity_impressionist/celebrities_impersonated	/base/americancomedy/celebrity_impressionist	/base/americancomedy/impersonated_celebrity
/location/country/second_level_divisions	/location/country	/location/administrative_division
/influence/influence_node/peers./influence/peer_relationship/peers	/influence/influence_node	/influence/influence_node
/film/film/music	/film/film	/film/music_contributor
/people/person/spouse_s./people/marriage/location_of_ceremony	/people/person	/location/location
/people/person/religion	/people/person	/religion/religion
/base/popstra/celebrity/breakup./base/popstra/breakup/participant	/base/popstra/celebrity	/base/popstra/celebrity
/location/location/partially_contains	/location/location	/location/location
/people/person/spouse_s./people/marriage/spouse	/people/person	/people/person
/olympics/olympic_sport/athletes./olympics/olympic_athlete_affiliation/country	/olympics/olympic_sport	/olympics/olympic_participating_country
/business/business_operation/assets./measurement_unit/dated_money_value/currency	/business/business_operation	/finance/currency
/tv/tv_program/regular_cast./tv/regular_tv_appearance/actor	/tv/tv_program	/tv/tv_actor
/olympics/olympic_sport/athletes./olympics/olympic_athlete_affiliation/olympics	/olympics/olympic_sport	/olympics/olympic_games
/music/artist/track_contributions./music/track_contribution/role	/music/artist	/music/performance_role
/military/military_conflict/combatants./military/military_combatant_group/combatants	/military/military_conflict	/military/military_combatant
/film/film/production_companies	/film/film	/film/production_company
/base/saturdaynightlive/snl_cast_member/seasons./base/saturdaynightlive/snl_season_tenure/cast_members	/base/saturdaynightlive/snl_cast_member	/base/saturdaynightlive/snl_cast_member
/education/university/fraternities_and_sororities	/education/university	/education/fraternity_sorority
/location/country/form_of_government	/location/country	/government/form_of_government
/film/special_film_performance_type/film_performance_type./film/performance/film	/film/special_film_performance_type	/film/film
/government/politician/government_positions_held./government/government_position_held/basic_title	/government/politician	/government/government_office_category
/education/university/local_tuition./measurement_unit/dated_money_value/currency	/education/university	/finance/currency
/soccer/football_team/current_roster./sports/sports_team_roster/position	/soccer/football_team	/sports/sports_position
/location/statistical_region/gdp_real./measurement_unit/adjusted_money_value/adjustment_currency	/location/statistical_region	/finance/currency
/business/business_operation/industry	/business/business_operation	/business/industry
/film/film_set_designer/film_sets_designed	/film/film_set_designer	/film/film
/government/politician/government_positions_held./government/government_position_held/legislative_sessions	/government/politician	/government/legislative_session
/film/film/prequel	/film/film	/film/film
/film/film/written_by	/film/film	/film/writer
/location/location/time_zones	/location/location	/time/time_zone
/people/ethnicity/people	/people/ethnicity	/people/person
/celebrities/celebrity/celebrity_friends./celebrities/friendship/friend	/celebrities/celebrity	/celebrities/celebrity
/olympics/olympic_participating_country/medals_won./olympics/olympic_medal_honor/medal	/olympics/olympic_participating_country	/olympics/olympic_medal
/organization/organization/headquarters./location/mailing_address/country	/organization/organization	/location/country
/education/educational_degree/people_with_this_degree./education/education/student	/education/educational_degree	/people/person
/tv/tv_writer/tv_programs./tv/tv_program_writer_relationship/tv_program	/tv/tv_writer	/tv/tv_program
/tv/tv_producer/programs_produced./tv/tv_producer_term/program	/tv/tv_producer	/tv/tv_program
/tv/tv_program/program_creator	/tv/tv_program	/tv/tv_program_creator
/music/performance_role/regular_performances./music/group_membership/group	/music/performance_role	/music/musical_group
/music/performance_role/track_performances./music/track_contribution/role	/music/performance_role	/music/performance_role
/base/schemastaging/organization_extra/phone_number./base/schemastaging/phone_sandbox/service_language	/base/schemastaging/organization_extra	/language/human_language
/award/award_winning_work/awards_won./award/award_honor/honored_for	/award/award_winning_work	/award/award_winning_work
/education/university/international_tuition./measurement_unit/dated_money_value/currency	/education/university	/finance/currency
/music/group_member/membership./music/group_membership/role	/music/group_member	/music/performance_role
/location/hud_foreclosure_area/estimated_number_of_mortgages./measurement_unit/dated_integer/source	/location/hud_foreclosure_area	/dataworld/information_source
/film/film/distributors./film/film_film_distributor_relationship/region	/film/film	/location/location
/base/locations/continents/countries_within	/base/locations/continents	/base/locations/countries
/award/award_winning_work/awards_won./award/award_honor/award	/award/award_winning_work	/award/award_category
/award/award_category/winners./award/award_honor/ceremony	/award/award_category	/award/award_ceremony
/music/performance_role/regular_performances./music/group_membership/role	/music/performance_role	/music/performance_role
/location/statistical_region/religions./location/religion_percentage/religion	/location/statistical_region	/religion/religion
/government/governmental_body/members./government/government_position_held/legislative_sessions	/government/governmental_body	/government/legislative_session
/military/military_combatant/military_conflicts./military/military_combatant_group/combatants	/military/military_combatant	/military/military_combatant
/people/ethnicity/languages_spoken	/people/ethnicity	/language/human_language
/people/person/profession	/people/person	/people/profession
/user/alexander/philosophy/philosopher/interests	/user/alexander/philosophy/philosopher	/user/alexander/philosophy/subject
/people/deceased_person/place_of_death	/people/deceased_person	/location/location
/award/award_nominee/award_nominations./award/award_nomination/nominated_for	/award/award_nominee	/award/award_nominated_work
/base/popstra/celebrity/canoodled./base/popstra/canoodled/participant	/base/popstra/celebrity	/base/popstra/celebrity
/film/film_distributor/films_distributed./film/film_film_distributor_relationship/film	/film/film_distributor	/film/film
/user/tsegaran/random/taxonomy_subject/entry./user/tsegaran/random/taxonomy_entry/taxonomy	/user/tsegaran/random/taxonomy_subject	/user/tsegaran/random/subject_taxonomy
/location/statistical_region/gdp_nominal_per_capita./measurement_unit/dated_money_value/currency	/location/statistical_region	/finance/currency
/organization/organization/place_founded	/organization/organization	/location/location
/base/eating/practicer_of_diet/diet	/base/eating/practicer_of_diet	/base/eating/diets
/people/person/employment_history./business/employment_tenure/company	/people/person	/business/employer
/film/film/edited_by	/film/film	/film/editor
/education/educational_institution/school_type	/education/educational_institution	/education/school_category
/government/legislative_session/members./government/government_position_held/legislative_sessions	/government/legislative_session	/government/legislative_session
/location/hud_county_place/place	/location/hud_county_place	/location/location
/user/ktrueman/default_domain/international_organization/member_states	/user/ktrueman/default_domain/international_organization	/location/country
/sports/sport/pro_athletes./sports/pro_sports_played/athlete	/sports/sport	/sports/pro_athlete
/travel/travel_destination/how_to_get_here./travel/transportation/mode_of_transportation	/travel/travel_destination	/travel/transportation_mode
/organization/endowed_organization/endowment./measurement_unit/dated_money_value/currency	/organization/endowed_organization	/finance/currency
/media_common/netflix_genre/titles	/media_common/netflix_genre	/media_common/netflix_title
/sports/sports_position/players./sports/sports_team_roster/team	/sports/sports_position	/sports/sports_team
/business/business_operation/revenue./measurement_unit/dated_money_value/currency	/business/business_operation	/finance/currency
/people/person/spouse_s./people/marriage/type_of_union	/people/person	/people/marriage_union_type
/film/film/film_production_design_by	/film/film	/film/film_production_designer
/base/schemastaging/organization_extra/phone_number./base/schemastaging/phone_sandbox/contact_category	/base/schemastaging/organization_extra	/organization/contact_category
/education/educational_institution/colors	/education/educational_institution	/visual_art/color
/business/job_title/people_with_this_title./business/employment_tenure/company	/business/job_title	/business/employer
/common/topic/webpage./common/webpage/category	/common/topic	/common/annotation_category
/sports/sports_team_location/teams	/sports/sports_team_location	/sports/sports_team
/people/person/languages	/people/person	/language/human_language
/time/event/instance_of_recurring_event	/time/event	/time/recurring_event
/film/film/country	/film/film	/location/country
/american_football/football_team/current_roster./sports/sports_team_roster/position	/american_football/football_team	/sports/sports_position
/tv/tv_program/languages	/tv/tv_program	/language/human_language
/dataworld/gardening_hint/split_to	/dataworld/gardening_hint	/type/object
/tv/tv_network/programs./tv/tv_network_duration/program	/tv/tv_network	/tv/tv_program
/olympics/olympic_games/participating_countries	/olympics/olympic_games	/olympics/olympic_participating_country
/base/popstra/location/vacationers./base/popstra/vacation_choice/vacationer	/base/popstra/location	/base/popstra/celebrity
/medicine/disease/notable_people_with_this_condition	/medicine/disease	/medicine/notable_person_with_medical_condition
/education/educational_degree/people_with_this_degree./education/education/major_field_of_study	/education/educational_degree	/education/field_of_study
/sports/pro_athlete/teams./sports/sports_team_roster/team	/sports/pro_athlete	/sports/sports_team
/tv/tv_program/country_of_origin	/tv/tv_program	/location/country
/education/field_of_study/students_majoring./education/education/student	/education/field_of_study	/people/person
/film/actor/film./film/performance/special_performance_type	/film/actor	/film/special_film_performance_type
/music/record_label/artist	/music/record_label	/music/artist
/organization/organization/headquarters./location/mailing_address/state_province_region	/organization/organization	/location/administrative_division
/organization/organization/child./organization/organization_relationship/child	/organization/organization	/organization/organization
/film/film/genre	/film/film	/film/film_genre
/olympics/olympic_participating_country/athletes./olympics/olympic_athlete_affiliation/olympics	/olympics/olympic_participating_country	/olympics/olympic_games
/award/award_category/winners./award/award_honor/award_winner	/award/award_category	/award/award_winner
/olympics/olympic_games/sports	/olympics/olympic_games	/olympics/olympic_sport
/organization/organization_founder/organizations_founded	/organization/organization_founder	/organization/organization
/base/culturalevent/event/entity_involved	/base/culturalevent/event	/common/topic
/music/performance_role/guest_performances./music/recording_contribution/performance_role	/music/performance_role	/music/performance_role
/tv/tv_program/tv_producer./tv/tv_producer_term/producer_type	/tv/tv_program	/tv/tv_producer_type
/film/film/costume_design_by	/film/film	/film/film_costumer_designer
/government/government_office_category/officeholders./government/government_position_held/jurisdiction_of_office	/government/government_office_category	/government/governmental_jurisdiction
/film/film/estimated_budget./measurement_unit/dated_money_value/currency	/film/film	/finance/currency
/location/country/capital	/location/country	/location/citytown
/location/location/adjoin_s./location/adjoining_relationship/adjoins	/location/location	/location/location
/film/film/produced_by	/film/film	/film/producer
/music/artist/origin	/music/artist	/location/location
/sports/professional_sports_team/draft_picks./sports/sports_league_draft_pick/school	/sports/professional_sports_team	/education/educational_institution
/people/marriage_union_type/unions_of_this_type./people/marriage/location_of_ceremony	/people/marriage_union_type	/location/location
/film/film/language	/film/film	/language/human_language
/medicine/symptom/symptom_of	/medicine/symptom	/medicine/disease
/base/schemastaging/person_extra/net_worth./measurement_unit/dated_money_value/currency	/base/schemastaging/person_extra	/finance/currency
/base/marchmadness/ncaa_basketball_tournament/seeds./base/marchmadness/ncaa_tournament_seed/team	/base/marchmadness/ncaa_basketball_tournament	/base/marchmadness/ncaa_basketball_team
/tv/tv_personality/tv_regular_appearances./tv/tv_regular_personal_appearance/program	/tv/tv_personality	/tv/tv_program
/location/statistical_region/places_exported_to./location/imports_and_exports/exported_to	/location/statistical_region	/location/statistical_region
/film/film/film_festivals	/film/film	/film/film_festival_event
/location/statistical_region/gdp_nominal./measurement_unit/dated_money_value/currency	/location/statistical_region	/finance/currency
/location/us_county/county_seat	/location/us_county	/location/citytown
/award/award_ceremony/awards_presented./award/award_honor/honored_for	/award/award_ceremony	/award/award_winning_work
/award/award_nominated_work/award_nominations./award/award_nomination/nominated_for	/award/award_nominated_work	/award/award_nominated_work
/film/film/runtime./film/film_cut/film_release_region	/film/film	/location/location
/film/director/film	/film/director	/film/film
/base/popstra/celebrity/dated./base/popstra/dated/participant	/base/popstra/celebrity	/base/popstra/celebrity
/location/administrative_division/first_level_division_of	/location/administrative_division	/location/country
/base/x2010fifaworldcupsouthafrica/world_cup_squad/current_world_cup_squad./base/x2010fifaworldcupsouthafrica/current_world_cup_squad/current_club	/base/x2010fifaworldcupsouthafrica/world_cup_squad	/soccer/football_team
/film/film/film_format	/film/film	/film/film_format
/film/film/featured_film_locations	/film/film	/film/film_location
/travel/travel_destination/climate./travel/travel_destination_monthly_climate/month	/travel/travel_destination	/time/month
/tv/tv_producer/programs_produced./tv/tv_producer_term/producer_type	/tv/tv_producer	/tv/tv_producer_type
/influence/influence_node/influenced_by	/influence/influence_node	/influence/influence_node
/location/hud_county_place/county	/location/hud_county_place	/location/us_county
/broadcast/content/artist	/broadcast/content	/broadcast/artist
/base/petbreeds/city_with_dogs/top_breeds./base/petbreeds/dog_city_relationship/dog_breed	/base/petbreeds/city_with_dogs	/base/petbreeds/dog_breed
/organization/organization/headquarters./location/mailing_address/citytown	/organization/organization	/location/location
/people/person/places_lived./people/place_lived/location	/people/person	/location/location
/music/instrument/family	/music/instrument	/music/instrument
/education/educational_institution/students_graduates./education/education/student	/education/educational_institution	/people/person
/olympics/olympic_participating_country/medals_won./olympics/olympic_medal_honor/olympics	/olympics/olympic_participating_country	/olympics/olympic_games
/film/film/cinematography	/film/film	/film/cinematographer
/film/film/other_crew./film/film_crew_gig/film_crew_role	/film/film	/film/film_job
/film/film/release_date_s./film/film_regional_release_date/film_release_region	/film/film	/location/location
/sports/professional_sports_team/draft_picks./sports/sports_league_draft_pick/draft	/sports/professional_sports_team	/sports/sports_league_draft
/olympics/olympic_games/medals_awarded./olympics/olympic_medal_honor/medal	/olympics/olympic_games	/olympics/olympic_medal
/award/award_category/nominees./award/award_nomination/nominated_for	/award/award_category	/award/award_nominated_work
/award/award_nominee/award_nominations./award/award_nomination/award_nominee	/award/award_nominee	/award/award_nominee
/location/administrative_division/country	/location/administrative_division	/location/country
/film/film/distributors./film/film_film_distributor_relationship/film_distribution_medium	/film/film	/film/film_distribution_medium
/people/person/gender	/people/person	/people/gender
/award/hall_of_fame/inductees./award/hall_of_fame_induction/inductee	/award/hall_of_fame	/award/hall_of_fame_inductee
/award/award_nominee/award_nominations./award/award_nomination/award	/award/award_nominee	/award/award_category
/tv/non_character_role/tv_regular_personal_appearances./tv/tv_regular_personal_appearance/person	/tv/non_character_role	/tv/tv_personality
/sports/sports_league_draft/picks./sports/sports_league_draft_pick/school	/sports/sports_league_draft	/education/educational_institution
/location/location/contains	/location/location	/location/location
/film/film/other_crew./film/film_crew_gig/crewmember	/film/film	/film/film_crewmember
/language/human_language/countries_spoken_in	/language/human_language	/location/country
/education/educational_institution/campuses	/education/educational_institution	/education/educational_institution_campus
/sports/sports_team/sport	/sports/sports_team	/sports/sport
/award/award_winning_work/awards_won./award/award_honor/award_winner	/award/award_winning_work	/award/award_winner
/business/business_operation/operating_income./measurement_unit/dated_money_value/currency	/business/business_operation	/finance/currency
/education/educational_degree/people_with_this_degree./education/education/institution	/education/educational_degree	/education/educational_institution
/film/person_or_entity_appearing_in_film/films./film/personal_film_appearance/type_of_appearance	/film/person_or_entity_appearing_in_film	/film/personal_film_appearance_type
/base/aareas/schema/administrative_area/administrative_area_type	/base/aareas/schema/administrative_area	/base/aareas/schema/administrative_area_type
/film/actor/film./film/performance/film	/film/actor	/film/film
/food/food/nutrients./food/nutrition_fact/nutrient	/food/food	/food/nutrient
/ice_hockey/hockey_team/current_roster./sports/sports_team_roster/position	/ice_hockey/hockey_team	/sports/sports_position
/film/film/personal_appearances./film/personal_film_appearance/person	/film/film	/film/person_or_entity_appearing_in_film
/time/event/locations	/time/event	/location/location
/organization/role/leaders./organization/leadership/organization	/organization/role	/organization/organization
/film/film/story_by	/film/film	/film/film_story_contributor
/award/award_ceremony/awards_presented./award/award_honor/award_winner	/award/award_ceremony	/award/award_winner
/award/ranked_item/appears_in_ranked_lists./award/ranking/list	/award/ranked_item	/award/ranked_list
/government/legislative_session/members./government/government_position_held/district_represented	/government/legislative_session	/government/political_district
/film/film_subject/films	/film/film_subject	/film/film
/base/popstra/celebrity/friendship./base/popstra/friendship/participant	/base/popstra/celebrity	/base/popstra/celebrity
/base/schemastaging/organization_extra/phone_number./base/schemastaging/phone_sandbox/service_location	/base/schemastaging/organization_extra	/location/location
/celebrities/celebrity/sexual_relationships./celebrities/romantic_relationship/celebrity	/celebrities/celebrity	/celebrities/celebrity
/location/statistical_region/gni_per_capita_in_ppp_dollars./measurement_unit/dated_money_value/currency	/location/statistical_region	/finance/currency
/organization/non_profit_organization/registered_with./organization/non_profit_registration/registering_agency	/organization/non_profit_organization	/government/government_agency
/award/award_category/category_of	/award/award_category	/award/award
/film/film/executive_produced_by	/film/film	/film/producer
/location/country/official_language	/location/country	/language/human_language
/film/film/release_date_s./film/film_regional_release_date/film_release_distribution_medium	/film/film	/film/film_distribution_medium
/soccer/football_player/current_team./sports/sports_team_roster/team	/soccer/football_player	/sports/sports_team
/soccer/football_team/current_roster./soccer/football_roster_position/position	/soccer/football_team	/soccer/football_position
/sports/sports_team/roster./american_football/football_historical_roster_position/position_s	/sports/sports_team	/american_football/position
/sports/sports_team/roster./basketball/basketball_roster_position/position	/sports/sports_team	/basketball/basketball_position
/sports/sports_position/players./american_football/football_historical_roster_position/position_s	/sports/sports_position	/american_football/position
/sports/sports_team/roster./american_football/football_roster_position/position	/sports/sports_team	/american_football/position
/sports/sports_team/roster./baseball/baseball_roster_position/position	/sports/sports_team	/baseball/baseball_position